Grupamento_Atividades;Período;Estoque;Admissões;Desligamentos;Saldos
Administração Pública, Defesa e Seguridade Social;1/2020;977901;3961;4406;-445
Administração Pública, Defesa e Seguridade Social;1/2021;975935;6800;4582;2218
Administração Pública, Defesa e Seguridade Social;1/2022;976305;6084;4869;1215
Administração Pública, Defesa e Seguridade Social;1/2023;1003020;16266;8022;8244
Administração Pública, Defesa e Seguridade Social;10/2020;991552;1881;2435;-554
Administração Pública, Defesa e Seguridade Social;10/2021;992935;5043;4117;926
Administração Pública, Defesa e Seguridade Social;10/2022;1015854;6593;3938;2655
Administração Pública, Defesa e Seguridade Social;11/2020;989160;1640;4032;-2392
Administração Pública, Defesa e Seguridade Social;11/2021;992873;3736;3798;-62
Administração Pública, Defesa e Seguridade Social;11/2022;1017629;5781;4006;1775
Administração Pública, Defesa e Seguridade Social;12/2020;973717;1332;16775;-15443
Administração Pública, Defesa e Seguridade Social;12/2021;975090;2370;20153;-17783
Administração Pública, Defesa e Seguridade Social;12/2022;994776;4390;27243;-22853
Administração Pública, Defesa e Seguridade Social;2/2020;989152;15470;4219;11251
Administração Pública, Defesa e Seguridade Social;2/2021;982564;10619;3990;6629
Administração Pública, Defesa e Seguridade Social;2/2022;988018;20466;8753;11713
Administração Pública, Defesa e Seguridade Social;2/2023;1023101;26038;5957;20081
Administração Pública, Defesa e Seguridade Social;3/2020;992624;6957;3485;3472
Administração Pública, Defesa e Seguridade Social;3/2021;985816;7303;4051;3252
Administração Pública, Defesa e Seguridade Social;3/2022;993613;11487;5892;5595
Administração Pública, Defesa e Seguridade Social;3/2023;1031466;14132;5767;8365
Administração Pública, Defesa e Seguridade Social;4/2020;992574;2424;2474;-50
Administração Pública, Defesa e Seguridade Social;4/2021;987472;5201;3545;1656
Administração Pública, Defesa e Seguridade Social;4/2022;996545;8561;5629;2932
Administração Pública, Defesa e Seguridade Social;4/2023;1036047;9386;4805;4581
Administração Pública, Defesa e Seguridade Social;5/2020;993058;3235;2751;484
Administração Pública, Defesa e Seguridade Social;5/2021;988545;5050;3977;1073
Administração Pública, Defesa e Seguridade Social;5/2022;998306;7697;5936;1761
Administração Pública, Defesa e Seguridade Social;5/2023;1038763;8810;6094;2716
Administração Pública, Defesa e Seguridade Social;6/2020;992788;2402;2672;-270
Administração Pública, Defesa e Seguridade Social;6/2021;989226;4431;3750;681
Administração Pública, Defesa e Seguridade Social;6/2022;1001335;8324;5295;3029
Administração Pública, Defesa e Seguridade Social;7/2020;992313;2534;3009;-475
Administração Pública, Defesa e Seguridade Social;7/2021;989919;4363;3670;693
Administração Pública, Defesa e Seguridade Social;7/2022;1005434;9284;5185;4099
Administração Pública, Defesa e Seguridade Social;8/2020;992258;3255;3310;-55
Administração Pública, Defesa e Seguridade Social;8/2021;991065;5955;4809;1146
Administração Pública, Defesa e Seguridade Social;8/2022;1010036;10202;5600;4602
Administração Pública, Defesa e Seguridade Social;9/2020;992106;2262;2414;-152
Administração Pública, Defesa e Seguridade Social;9/2021;992009;5663;4719;944
Administração Pública, Defesa e Seguridade Social;9/2022;1013199;7858;4695;3163
Agricultura, pecuária, produção florestal, pesca e aquicultura;1/2020;1427862;69520;53425;16095
Agricultura, pecuária, produção florestal, pesca e aquicultura;1/2021;1509589;88199;55316;32883
Agricultura, pecuária, produção florestal, pesca e aquicultura;1/2022;1647477;106242;81228;25014
Agricultura, pecuária, produção florestal, pesca e aquicultura;1/2023;1708731;111632;88485;23147
Agricultura, pecuária, produção florestal, pesca e aquicultura;10/2020;1516795;65023;65320;-297
Agricultura, pecuária, produção florestal, pesca e aquicultura;10/2021;1665333;83540;89384;-5844
Agricultura, pecuária, produção florestal, pesca e aquicultura;10/2022;1740716;91032;92467;-1435
Agricultura, pecuária, produção florestal, pesca e aquicultura;11/2020;1500474;55550;71871;-16321
Agricultura, pecuária, produção florestal, pesca e aquicultura;11/2021;1648536;73989;90786;-16797
Agricultura, pecuária, produção florestal, pesca e aquicultura;11/2022;1722505;80060;98271;-18211
Agricultura, pecuária, produção florestal, pesca e aquicultura;12/2020;1476706;45905;69673;-23768
Agricultura, pecuária, produção florestal, pesca e aquicultura;12/2021;1622463;63456;89529;-26073
Agricultura, pecuária, produção florestal, pesca e aquicultura;12/2022;1685584;63391;100312;-36921
Agricultura, pecuária, produção florestal, pesca e aquicultura;2/2020;1432804;70254;65312;4942
Agricultura, pecuária, produção florestal, pesca e aquicultura;2/2021;1532464;87523;64648;22875
Agricultura, pecuária, produção florestal, pesca e aquicultura;2/2022;1664892;104570;87155;17415
Agricultura, pecuária, produção florestal, pesca e aquicultura;2/2023;1725015;104811;88527;16284
Agricultura, pecuária, produção florestal, pesca e aquicultura;3/2020;1428355;68635;73084;-4449
Agricultura, pecuária, produção florestal, pesca e aquicultura;3/2021;1535874;89350;85940;3410
Agricultura, pecuária, produção florestal, pesca e aquicultura;3/2022;1648897;98510;114505;-15995
Agricultura, pecuária, produção florestal, pesca e aquicultura;3/2023;1724683;117601;117933;-332
Agricultura, pecuária, produção florestal, pesca e aquicultura;4/2020;1422914;52759;58200;-5441
Agricultura, pecuária, produção florestal, pesca e aquicultura;4/2021;1547000;85399;74273;11126
Agricultura, pecuária, produção florestal, pesca e aquicultura;4/2022;1647876;95820;96841;-1021
Agricultura, pecuária, produção florestal, pesca e aquicultura;4/2023;1727585;103483;100581;2902
Agricultura, pecuária, produção florestal, pesca e aquicultura;5/2020;1438694;69794;54014;15780
Agricultura, pecuária, produção florestal, pesca e aquicultura;5/2021;1589280;105783;63503;42280
Agricultura, pecuária, produção florestal, pesca e aquicultura;5/2022;1674623;121088;94341;26747
Agricultura, pecuária, produção florestal, pesca e aquicultura;5/2023;1747144;128396;108837;19559
Agricultura, pecuária, produção florestal, pesca e aquicultura;6/2020;1475523;84013;47184;36829
Agricultura, pecuária, produção florestal, pesca e aquicultura;6/2021;1627661;104436;66055;38381
Agricultura, pecuária, produção florestal, pesca e aquicultura;6/2022;1709083;123008;88548;34460
Agricultura, pecuária, produção florestal, pesca e aquicultura;7/2020;1498488;73886;50921;22965
Agricultura, pecuária, produção florestal, pesca e aquicultura;7/2021;1653181;93045;67525;25520
Agricultura, pecuária, produção florestal, pesca e aquicultura;7/2022;1724953;103950;88080;15870
Agricultura, pecuária, produção florestal, pesca e aquicultura;8/2020;1509172;66190;55506;10684
Agricultura, pecuária, produção florestal, pesca e aquicultura;8/2021;1662291;84941;75831;9110
Agricultura, pecuária, produção florestal, pesca e aquicultura;8/2022;1732677;103696;95972;7724
Agricultura, pecuária, produção florestal, pesca e aquicultura;9/2020;1517092;68302;60382;7920
Agricultura, pecuária, produção florestal, pesca e aquicultura;9/2021;1671177;90004;81118;8886
Agricultura, pecuária, produção florestal, pesca e aquicultura;9/2022;1742151;99961;90487;9474
Alojamento e alimentação;1/2020;1796196;93304;90524;2780
Alojamento e alimentação;1/2021;1545148;79572;74854;4718
Alojamento e alimentação;1/2022;1715851;101794;99787;2007
Alojamento e alimentação;1/2023;1882657;113539;115891;-2352
Alojamento e alimentação;10/2020;1481475;81084;55159;25925
Alojamento e alimentação;10/2021;1657321;115681;82820;32861
Alojamento e alimentação;10/2022;1863519;116772;102177;14595
Alojamento e alimentação;11/2020;1517182;88563;52856;35707
Alojamento e alimentação;11/2021;1693737;118262;81846;36416
Alojamento e alimentação;11/2022;1884990;118602;97131;21471
Alojamento e alimentação;12/2020;1540430;81095;57847;23248
Alojamento e alimentação;12/2021;1713844;110965;90858;20107
Alojamento e alimentação;12/2022;1885009;102224;102205;19
Alojamento e alimentação;2/2020;1807886;98571;86881;11690
Alojamento e alimentação;2/2021;1561994;87386;70540;16846
Alojamento e alimentação;2/2022;1736290;118279;97840;20439
Alojamento e alimentação;2/2023;1898118;125257;109796;15461
Alojamento e alimentação;3/2020;1726512;71103;152477;-81374
Alojamento e alimentação;3/2021;1530981;58066;89079;-31013
Alojamento e alimentação;3/2022;1743341;114721;107670;7051
Alojamento e alimentação;3/2023;1909431;137023;125710;11313
Alojamento e alimentação;4/2020;1590110;12308;148710;-136402
Alojamento e alimentação;4/2021;1506418;43690;68253;-24563
Alojamento e alimentação;4/2022;1762757;117583;98167;19416
Alojamento e alimentação;4/2023;1918601;116169;106999;9170
Alojamento e alimentação;5/2020;1532103;14057;72064;-58007
Alojamento e alimentação;5/2021;1512460;65911;59869;6042
Alojamento e alimentação;5/2022;1784083;121221;99895;21326
Alojamento e alimentação;5/2023;1923947;120181;114835;5346
Alojamento e alimentação;6/2020;1493999;17676;55780;-38104
Alojamento e alimentação;6/2021;1530741;76580;58299;18281
Alojamento e alimentação;6/2022;1801841;113188;95430;17758
Alojamento e alimentação;7/2020;1467148;26227;53078;-26851
Alojamento e alimentação;7/2021;1559001;90393;62133;28260
Alojamento e alimentação;7/2022;1814274;113707;101274;12433
Alojamento e alimentação;8/2020;1451211;38785;54722;-15937
Alojamento e alimentação;8/2021;1592730;109908;76179;33729
Alojamento e alimentação;8/2022;1830858;123685;107101;16584
Alojamento e alimentação;9/2020;1455550;55397;51058;4339
Alojamento e alimentação;9/2021;1624460;111105;79375;31730
Alojamento e alimentação;9/2022;1848924;120619;102553;18066
Artes, Cultura, Esporte e Recreação;1/2020;240515;9984;8064;1920
Artes, Cultura, Esporte e Recreação;1/2021;212178;7233;7356;-123
Artes, Cultura, Esporte e Recreação;1/2022;232711;11750;8905;2845
Artes, Cultura, Esporte e Recreação;1/2023;259354;13762;10593;3169
Artes, Cultura, Esporte e Recreação;10/2020;210467;7955;5121;2834
Artes, Cultura, Esporte e Recreação;10/2021;226529;11202;7646;3556
Artes, Cultura, Esporte e Recreação;10/2022;254543;11072;9413;1659
Artes, Cultura, Esporte e Recreação;11/2020;213152;7726;5041;2685
Artes, Cultura, Esporte e Recreação;11/2021;229054;11003;8478;2525
Artes, Cultura, Esporte e Recreação;11/2022;256255;10878;9166;1712
Artes, Cultura, Esporte e Recreação;12/2020;212301;5947;6798;-851
Artes, Cultura, Esporte e Recreação;12/2021;229866;10035;9223;812
Artes, Cultura, Esporte e Recreação;12/2022;256185;10164;10234;-70
Artes, Cultura, Esporte e Recreação;2/2020;241986;9603;8132;1471
Artes, Cultura, Esporte e Recreação;2/2021;214159;8834;6853;1981
Artes, Cultura, Esporte e Recreação;2/2022;235622;12227;9316;2911
Artes, Cultura, Esporte e Recreação;2/2023;261839;12951;10466;2485
Artes, Cultura, Esporte e Recreação;3/2020;236674;6937;12249;-5312
Artes, Cultura, Esporte e Recreação;3/2021;211806;5693;8046;-2353
Artes, Cultura, Esporte e Recreação;3/2022;236782;12337;11177;1160
Artes, Cultura, Esporte e Recreação;3/2023;263156;14049;12732;1317
Artes, Cultura, Esporte e Recreação;4/2020;222090;884;15468;-14584
Artes, Cultura, Esporte e Recreação;4/2021;209980;4810;6636;-1826
Artes, Cultura, Esporte e Recreação;4/2022;240029;13116;9869;3247
Artes, Cultura, Esporte e Recreação;4/2023;265756;13142;10542;2600
Artes, Cultura, Esporte e Recreação;5/2020;216402;827;6515;-5688
Artes, Cultura, Esporte e Recreação;5/2021;210626;7547;6901;646
Artes, Cultura, Esporte e Recreação;5/2022;242485;11762;9306;2456
Artes, Cultura, Esporte e Recreação;5/2023;268090;12945;10611;2334
Artes, Cultura, Esporte e Recreação;6/2020;211881;1151;5672;-4521
Artes, Cultura, Esporte e Recreação;6/2021;212041;7788;6373;1415
Artes, Cultura, Esporte e Recreação;6/2022;244564;11288;9209;2079
Artes, Cultura, Esporte e Recreação;7/2020;209029;2114;4966;-2852
Artes, Cultura, Esporte e Recreação;7/2021;214596;8644;6089;2555
Artes, Cultura, Esporte e Recreação;7/2022;246825;11858;9597;2261
Artes, Cultura, Esporte e Recreação;8/2020;207225;3393;5197;-1804
Artes, Cultura, Esporte e Recreação;8/2021;219071;11393;6918;4475
Artes, Cultura, Esporte e Recreação;8/2022;250365;13878;10338;3540
Artes, Cultura, Esporte e Recreação;9/2020;207633;5392;4984;408
Artes, Cultura, Esporte e Recreação;9/2021;222973;11586;7684;3902
Artes, Cultura, Esporte e Recreação;9/2022;252884;12824;10305;2519
Atividades Administrativas e Serviços Complementares;1/2020;4441578;216781;208509;8272
Atividades Administrativas e Serviços Complementares;1/2021;4593580;250455;226388;24067
Atividades Administrativas e Serviços Complementares;1/2022;4968937;306583;272425;34158
Atividades Administrativas e Serviços Complementares;1/2023;5238084;314350;310146;4204
Atividades Administrativas e Serviços Complementares;10/2020;4480307;266338;196777;69561
Atividades Administrativas e Serviços Complementares;10/2021;4878240;291994;248939;43055
Atividades Administrativas e Serviços Complementares;10/2022;5222356;301852;268495;33357
Atividades Administrativas e Serviços Complementares;11/2020;4564452;274391;190246;84145
Atividades Administrativas e Serviços Complementares;11/2021;4951146;312965;240059;72906
Atividades Administrativas e Serviços Complementares;11/2022;5260148;312311;274519;37792
Atividades Administrativas e Serviços Complementares;12/2020;4569513;243467;238406;5061
Atividades Administrativas e Serviços Complementares;12/2021;4934779;281463;297830;-16367
Atividades Administrativas e Serviços Complementares;12/2022;5233880;274576;300844;-26268
Atividades Administrativas e Serviços Complementares;2/2020;4457097;210762;195243;15519
Atividades Administrativas e Serviços Complementares;2/2021;4635265;258222;216537;41685
Atividades Administrativas e Serviços Complementares;2/2022;5000231;304602;273308;31294
Atividades Administrativas e Serviços Complementares;2/2023;5260118;299190;277156;22034
Atividades Administrativas e Serviços Complementares;3/2020;4421106;220710;256701;-35991
Atividades Administrativas e Serviços Complementares;3/2021;4655793;255080;234552;20528
Atividades Administrativas e Serviços Complementares;3/2022;5012297;306371;294305;12066
Atividades Administrativas e Serviços Complementares;3/2023;5284491;349640;325267;24373
Atividades Administrativas e Serviços Complementares;4/2020;4329915;126071;217262;-91191
Atividades Administrativas e Serviços Complementares;4/2021;4659609;220209;216393;3816
Atividades Administrativas e Serviços Complementares;4/2022;5027716;290937;275518;15419
Atividades Administrativas e Serviços Complementares;4/2023;5305276;305164;284379;20785
Atividades Administrativas e Serviços Complementares;5/2020;4309316;140267;160866;-20599
Atividades Administrativas e Serviços Complementares;5/2021;4686453;249665;222821;26844
Atividades Administrativas e Serviços Complementares;5/2022;5052919;301098;275895;25203
Atividades Administrativas e Serviços Complementares;5/2023;5335130;333815;303961;29854
Atividades Administrativas e Serviços Complementares;6/2020;4324439;167005;151882;15123
Atividades Administrativas e Serviços Complementares;6/2021;4719366;254643;221730;32913
Atividades Administrativas e Serviços Complementares;6/2022;5094568;303331;261682;41649
Atividades Administrativas e Serviços Complementares;7/2020;4334744;138055;127750;10305
Atividades Administrativas e Serviços Complementares;7/2021;4756505;264970;227831;37139
Atividades Administrativas e Serviços Complementares;7/2022;5114652;303041;282957;20084
Atividades Administrativas e Serviços Complementares;8/2020;4368742;202485;168487;33998
Atividades Administrativas e Serviços Complementares;8/2021;4801649;286727;241583;45144
Atividades Administrativas e Serviços Complementares;8/2022;5151722;329105;292035;37070
Atividades Administrativas e Serviços Complementares;9/2020;4410746;227405;185401;42004
Atividades Administrativas e Serviços Complementares;9/2021;4835185;276415;242879;33536
Atividades Administrativas e Serviços Complementares;9/2022;5188999;310914;273637;37277
Atividades Financeiras, de Seguros e Serviços Relacionados;1/2020;960308;14406;12676;1730
Atividades Financeiras, de Seguros e Serviços Relacionados;1/2021;962227;17172;12622;4550
Atividades Financeiras, de Seguros e Serviços Relacionados;1/2022;1018072;18488;15191;3297
Atividades Financeiras, de Seguros e Serviços Relacionados;1/2023;1052329;19889;18604;1285
Atividades Financeiras, de Seguros e Serviços Relacionados;10/2020;953916;14251;16974;-2723
Atividades Financeiras, de Seguros e Serviços Relacionados;10/2021;1008244;22460;17300;5160
Atividades Financeiras, de Seguros e Serviços Relacionados;10/2022;1049196;19132;15986;3146
Atividades Financeiras, de Seguros e Serviços Relacionados;11/2020;955402;15106;13620;1486
Atividades Financeiras, de Seguros e Serviços Relacionados;11/2021;1013586;21075;15733;5342
Atividades Financeiras, de Seguros e Serviços Relacionados;11/2022;1051989;17795;15002;2793
Atividades Financeiras, de Seguros e Serviços Relacionados;12/2020;957677;13348;11073;2275
Atividades Financeiras, de Seguros e Serviços Relacionados;12/2021;1014775;16625;15436;1189
Atividades Financeiras, de Seguros e Serviços Relacionados;12/2022;1051044;13290;14235;-945
Atividades Financeiras, de Seguros e Serviços Relacionados;2/2020;962207;14331;12432;1899
Atividades Financeiras, de Seguros e Serviços Relacionados;2/2021;965480;17736;14483;3253
Atividades Financeiras, de Seguros e Serviços Relacionados;2/2022;1021787;19167;15452;3715
Atividades Financeiras, de Seguros e Serviços Relacionados;2/2023;1051479;16942;17792;-850
Atividades Financeiras, de Seguros e Serviços Relacionados;3/2020;964044;15305;13468;1837
Atividades Financeiras, de Seguros e Serviços Relacionados;3/2021;967827;19407;17060;2347
Atividades Financeiras, de Seguros e Serviços Relacionados;3/2022;1024977;20571;17381;3190
Atividades Financeiras, de Seguros e Serviços Relacionados;3/2023;1050930;19780;20329;-549
Atividades Financeiras, de Seguros e Serviços Relacionados;4/2020;958510;5328;10862;-5534
Atividades Financeiras, de Seguros e Serviços Relacionados;4/2021;974348;20510;13989;6521
Atividades Financeiras, de Seguros e Serviços Relacionados;4/2022;1028893;21462;17546;3916
Atividades Financeiras, de Seguros e Serviços Relacionados;4/2023;1051241;19009;18698;311
Atividades Financeiras, de Seguros e Serviços Relacionados;5/2020;955167;5833;9176;-3343
Atividades Financeiras, de Seguros e Serviços Relacionados;5/2021;979717;20045;14676;5369
Atividades Financeiras, de Seguros e Serviços Relacionados;5/2022;1031827;21079;18145;2934
Atividades Financeiras, de Seguros e Serviços Relacionados;5/2023;1051421;19556;19376;180
Atividades Financeiras, de Seguros e Serviços Relacionados;6/2020;953985;7656;8838;-1182
Atividades Financeiras, de Seguros e Serviços Relacionados;6/2021;985468;21236;15485;5751
Atividades Financeiras, de Seguros e Serviços Relacionados;6/2022;1035488;21052;17391;3661
Atividades Financeiras, de Seguros e Serviços Relacionados;7/2020;954095;9966;9856;110
Atividades Financeiras, de Seguros e Serviços Relacionados;7/2021;990995;21828;16301;5527
Atividades Financeiras, de Seguros e Serviços Relacionados;7/2022;1038407;20270;17351;2919
Atividades Financeiras, de Seguros e Serviços Relacionados;8/2020;955354;11807;10548;1259
Atividades Financeiras, de Seguros e Serviços Relacionados;8/2021;996981;22451;16465;5986
Atividades Financeiras, de Seguros e Serviços Relacionados;8/2022;1042493;21921;17835;4086
Atividades Financeiras, de Seguros e Serviços Relacionados;9/2020;956639;12944;11659;1285
Atividades Financeiras, de Seguros e Serviços Relacionados;9/2021;1003084;22574;16471;6103
Atividades Financeiras, de Seguros e Serviços Relacionados;9/2022;1046050;20236;16679;3557
Atividades Imobiliárias;1/2020;158800;5654;4591;1063
Atividades Imobiliárias;1/2021;163172;6204;4203;2001
Atividades Imobiliárias;1/2022;179831;6998;5932;1066
Atividades Imobiliárias;1/2023;186249;6948;6745;203
Atividades Imobiliárias;10/2020;158766;5699;4068;1631
Atividades Imobiliárias;10/2021;177011;6731;5674;1057
Atividades Imobiliárias;10/2022;186853;6567;5817;750
Atividades Imobiliárias;11/2020;160463;5333;3636;1697
Atividades Imobiliárias;11/2021;178791;6939;5159;1780
Atividades Imobiliárias;11/2022;186989;6055;5919;136
Atividades Imobiliárias;12/2020;161171;4604;3896;708
Atividades Imobiliárias;12/2021;178765;5617;5643;-26
Atividades Imobiliárias;12/2022;186046;4802;5745;-943
Atividades Imobiliárias;2/2020;159896;5649;4553;1096
Atividades Imobiliárias;2/2021;164913;6402;4661;1741
Atividades Imobiliárias;2/2022;181207;7918;6542;1376
Atividades Imobiliárias;2/2023;186633;6753;6369;384
Atividades Imobiliárias;3/2020;159908;5085;5073;12
Atividades Imobiliárias;3/2021;166444;6198;4667;1531
Atividades Imobiliárias;3/2022;182506;8117;6818;1299
Atividades Imobiliárias;3/2023;187273;8282;7642;640
Atividades Imobiliárias;4/2020;156302;1678;5284;-3606
Atividades Imobiliárias;4/2021;167903;5640;4181;1459
Atividades Imobiliárias;4/2022;183558;7526;6474;1052
Atividades Imobiliárias;4/2023;187931;7115;6457;658
Atividades Imobiliárias;5/2020;154688;2353;3967;-1614
Atividades Imobiliárias;5/2021;169244;6156;4815;1341
Atividades Imobiliárias;5/2022;184283;7715;6990;725
Atividades Imobiliárias;5/2023;188404;7530;7057;473
Atividades Imobiliárias;6/2020;154225;2907;3370;-463
Atividades Imobiliárias;6/2021;171000;6521;4765;1756
Atividades Imobiliárias;6/2022;184764;7107;6626;481
Atividades Imobiliárias;7/2020;154874;4181;3532;649
Atividades Imobiliárias;7/2021;172672;6551;4879;1672
Atividades Imobiliárias;7/2022;184815;7187;7136;51
Atividades Imobiliárias;8/2020;155876;4479;3477;1002
Atividades Imobiliárias;8/2021;174413;7029;5288;1741
Atividades Imobiliárias;8/2022;185463;7546;6898;648
Atividades Imobiliárias;9/2020;157135;5094;3835;1259
Atividades Imobiliárias;9/2021;175954;7114;5573;1541
Atividades Imobiliárias;9/2022;186103;6880;6240;640
Atividades Profissionais, Científicas e Técnicas;1/2020;1120846;48125;39035;9090
Atividades Profissionais, Científicas e Técnicas;1/2021;1167066;56218;38103;18115
Atividades Profissionais, Científicas e Técnicas;1/2022;1313286;68337;55437;12900
Atividades Profissionais, Científicas e Técnicas;1/2023;1424987;72463;62713;9750
Atividades Profissionais, Científicas e Técnicas;10/2020;1138981;55301;35761;19540
Atividades Profissionais, Científicas e Técnicas;10/2021;1294052;64896;54218;10678
Atividades Profissionais, Científicas e Técnicas;10/2022;1416535;67654;57677;9977
Atividades Profissionais, Científicas e Técnicas;11/2020;1152354;49014;35641;13373
Atividades Profissionais, Científicas e Técnicas;11/2021;1307849;64444;50647;13797
Atividades Profissionais, Científicas e Técnicas;11/2022;1425971;64826;55390;9436
Atividades Profissionais, Científicas e Técnicas;12/2020;1148951;37908;41311;-3403
Atividades Profissionais, Científicas e Técnicas;12/2021;1300386;50565;58028;-7463
Atividades Profissionais, Científicas e Técnicas;12/2022;1415237;49306;60040;-10734
Atividades Profissionais, Científicas e Técnicas;2/2020;1127981;45017;37882;7135
Atividades Profissionais, Científicas e Técnicas;2/2021;1182567;56608;41107;15501
Atividades Profissionais, Científicas e Técnicas;2/2022;1326986;69730;56030;13700
Atividades Profissionais, Científicas e Técnicas;2/2023;1433240;66682;58429;8253
Atividades Profissionais, Científicas e Técnicas;3/2020;1125959;44777;46799;-2022
Atividades Profissionais, Científicas e Técnicas;3/2021;1198769;61028;44826;16202
Atividades Profissionais, Científicas e Técnicas;3/2022;1340192;75264;62058;13206
Atividades Profissionais, Científicas e Técnicas;3/2023;1443075;79286;69451;9835
Atividades Profissionais, Científicas e Técnicas;4/2020;1103374;18259;40844;-22585
Atividades Profissionais, Científicas e Técnicas;4/2021;1211041;55510;43238;12272
Atividades Profissionais, Científicas e Técnicas;4/2022;1350949;69844;59087;10757
Atividades Profissionais, Científicas e Técnicas;4/2023;1450692;66151;58534;7617
Atividades Profissionais, Científicas e Técnicas;5/2020;1092569;21485;32290;-10805
Atividades Profissionais, Científicas e Técnicas;5/2021;1225753;60127;45415;14712
Atividades Profissionais, Científicas e Técnicas;5/2022;1362969;71266;59246;12020
Atividades Profissionais, Científicas e Técnicas;5/2023;1454923;70531;66300;4231
Atividades Profissionais, Científicas e Técnicas;6/2020;1088680;26518;30407;-3889
Atividades Profissionais, Científicas e Técnicas;6/2021;1240649;59421;44525;14896
Atividades Profissionais, Científicas e Técnicas;6/2022;1374307;67870;56532;11338
Atividades Profissionais, Científicas e Técnicas;7/2020;1094342;35063;29401;5662
Atividades Profissionais, Científicas e Técnicas;7/2021;1254520;62309;48438;13871
Atividades Profissionais, Científicas e Técnicas;7/2022;1383852;67349;57804;9545
Atividades Profissionais, Científicas e Técnicas;8/2020;1107108;43322;30556;12766
Atividades Profissionais, Científicas e Técnicas;8/2021;1269816;64957;49661;15296
Atividades Profissionais, Científicas e Técnicas;8/2022;1396884;74346;61314;13032
Atividades Profissionais, Científicas e Técnicas;9/2020;1119441;45533;33200;12333
Atividades Profissionais, Científicas e Técnicas;9/2021;1283374;64625;51067;13558
Atividades Profissionais, Científicas e Técnicas;9/2022;1406558;72077;62403;9674
"Comércio; reparação de veículos automotores e motocicletas";1/2020;8586009;308116;361605;-53489
"Comércio; reparação de veículos automotores e motocicletas";1/2021;8662868;343287;336315;6972
"Comércio; reparação de veículos automotores e motocicletas";1/2022;9252960;368425;428513;-60088
"Comércio; reparação de veículos automotores e motocicletas";1/2023;9613485;401624;455148;-53524
"Comércio; reparação de veículos automotores e motocicletas";10/2020;8419309;397125;282943;114182
"Comércio; reparação de veículos automotores e motocicletas";10/2021;9164748;433236;362881;70355
"Comércio; reparação de veículos automotores e motocicletas";10/2022;9578315;443634;394278;49356
"Comércio; reparação de veículos automotores e motocicletas";11/2020;8596744;436572;259137;177435
"Comércio; reparação de veículos automotores e motocicletas";11/2021;9304035;475000;335713;139287
"Comércio; reparação de veículos automotores e motocicletas";11/2022;9684284;476560;370591;105969
"Comércio; reparação de veículos automotores e motocicletas";12/2020;8655896;360180;301028;59152
"Comércio; reparação de veículos automotores e motocicletas";12/2021;9313048;390748;381735;9013
"Comércio; reparação de veículos automotores e motocicletas";12/2022;9667009;387648;404923;-17275
"Comércio; reparação de veículos automotores e motocicletas";2/2020;8592252;333131;326888;6243
"Comércio; reparação de veículos automotores e motocicletas";2/2021;8728804;386423;320487;65936
"Comércio; reparação de veículos automotores e motocicletas";2/2022;9266179;428466;415247;13219
"Comércio; reparação de veículos automotores e motocicletas";2/2023;9612160;419008;420333;-1325
"Comércio; reparação de veículos automotores e motocicletas";3/2020;8519525;311296;384023;-72727
"Comércio; reparação de veículos automotores e motocicletas";3/2021;8742940;352666;338530;14136
"Comércio; reparação de veículos automotores e motocicletas";3/2022;9266531;435469;435117;352
"Comércio; reparação de veículos automotores e motocicletas";3/2023;9630715;492497;473942;18555
"Comércio; reparação de veículos automotores e motocicletas";4/2020;8276328;116937;360134;-243197
"Comércio; reparação de veículos automotores e motocicletas";4/2021;8749725;297448;290663;6785
"Comércio; reparação de veículos automotores e motocicletas";4/2022;9295792;423529;394268;29261
"Comércio; reparação de veículos automotores e motocicletas";4/2023;9658274;423690;396131;27559
"Comércio; reparação de veículos automotores e motocicletas";5/2020;8182054;144197;238471;-94274
"Comércio; reparação de veículos automotores e motocicletas";5/2021;8809254;353869;294340;59529
"Comércio; reparação de veículos automotores e motocicletas";5/2022;9343349;448810;401253;47557
"Comércio; reparação de veículos automotores e motocicletas";5/2023;9673686;449993;434581;15412
"Comércio; reparação de veículos automotores e motocicletas";6/2020;8162255;191301;211100;-19799
"Comércio; reparação de veículos automotores e motocicletas";6/2021;8881729;378302;305827;72475
"Comércio; reparação de veículos automotores e motocicletas";6/2022;9390525;436638;389462;47176
"Comércio; reparação de veículos automotores e motocicletas";7/2020;8188396;245220;219079;26141
"Comércio; reparação de veículos automotores e motocicletas";7/2021;8956309;390197;315617;74580
"Comércio; reparação de veículos automotores e motocicletas";7/2022;9429099;437488;398914;38574
"Comércio; reparação de veículos automotores e motocicletas";8/2020;8236066;279049;231379;47670
"Comércio; reparação de veículos automotores e motocicletas";8/2021;9033998;417484;339795;77689
"Comércio; reparação de veículos automotores e motocicletas";8/2022;9470985;466529;424643;41886
"Comércio; reparação de veículos automotores e motocicletas";9/2020;8305127;324027;254966;69061
"Comércio; reparação de veículos automotores e motocicletas";9/2021;9094393;418178;357783;60395
"Comércio; reparação de veículos automotores e motocicletas";9/2022;9528959;451905;393931;57974
Construção;1/2020;1875396;143164;111392;31772
Construção;1/2021;2010248;159138;114198;44940
Construção;1/2022;2254701;182135;145326;36809
Construção;1/2023;2459699;198850;159885;38965
Construção;10/2020;1988570;156900;120024;36876
Construção;10/2021;2257440;166443;149207;17236
Construção;10/2022;2514008;174681;169333;5348
Construção;11/2020;2009666;141136;120040;21096
Construção;11/2021;2269925;162384;149899;12485
Construção;11/2022;2495239;158287;177056;-18769
Construção;12/2020;1965308;94316;138674;-44358
Construção;12/2021;2217892;113698;165731;-52033
Construção;12/2022;2420734;110955;185460;-74505
Construção;2/2020;1898863;137113;113646;23467
Construção;2/2021;2054446;166683;122485;44198
Construção;2/2022;2294154;192311;152858;39453
Construção;2/2023;2481945;183041;160795;22246
Construção;3/2020;1885686;125344;138521;-13177
Construção;3/2021;2079853;162863;137456;25407
Construção;3/2022;2319213;191104;166045;25059
Construção;3/2023;2515586;216380;182739;33641
Construção;4/2020;1816116;59027;128597;-69570
Construção;4/2021;2102969;148046;124930;23116
Construção;4/2022;2344554;179899;154558;25341
Construção;4/2023;2542523;183566;156629;26937
Construção;5/2020;1795470;86416;107062;-20646
Construção;5/2021;2126641;158857;135185;23672
Construção;5/2022;2379999;201708;166263;35445
Construção;5/2023;2570481;208231;180273;27958
Construção;6/2020;1812486;114898;97882;17016
Construção;6/2021;2149969;162207;138879;23328
Construção;6/2022;2410256;192229;161972;30257
Construção;7/2020;1854439;140688;98735;41953
Construção;7/2021;2180608;169142;138503;30639
Construção;7/2022;2442338;195679;163597;32082
Construção;8/2020;1905287;151653;100805;50848
Construção;8/2021;2213998;176521;143131;33390
Construção;8/2022;2477494;211068;175912;35156
Construção;9/2020;1951694;155971;109564;46407
Construção;9/2021;2240204;170070;143864;26206
Construção;9/2022;2508660;197256;166090;31166
Educação;1/2020;1809223;50125;43144;6981
Educação;1/2021;1718979;32709;37794;-5085
Educação;1/2022;1773438;58627;47431;11196
Educação;1/2023;1865472;62104;56637;5467
Educação;10/2020;1767933;20851;21475;-624
Educação;10/2021;1822172;39941;30719;9222
Educação;10/2022;1938593;42249;35430;6819
Educação;11/2020;1768076;19452;19309;143
Educação;11/2021;1824786;32238;29624;2614
Educação;11/2022;1936156;31449;33886;-2437
Educação;12/2020;1724064;12225;56237;-44012
Educação;12/2021;1762242;19236;81780;-62544
Educação;12/2022;1860005;16760;92911;-76151
Educação;2/2020;1858712;92291;42802;49489
Educação;2/2021;1746552;69644;42071;27573
Educação;2/2022;1839945;122165;55658;66507
Educação;2/2023;1923679;114373;56166;58207
Educação;3/2020;1869023;49058;38747;10311
Educação;3/2021;1759356;47502;34698;12804
Educação;3/2022;1868197;79428;51176;28252
Educação;3/2023;1946013;79184;56850;22334
Educação;4/2020;1845399;8713;32337;-23624
Educação;4/2021;1764290;31761;26827;4934
Educação;4/2022;1885379;61151;43969;17182
Educação;4/2023;1961236;57981;42758;15223
Educação;5/2020;1826391;7311;26319;-19008
Educação;5/2021;1774139;37262;27413;9849
Educação;5/2022;1897587;55669;43461;12208
Educação;5/2023;1970760;55429;45905;9524
Educação;6/2020;1805974;8517;28934;-20417
Educação;6/2021;1776128;34483;32494;1989
Educação;6/2022;1896913;46535;47209;-674
Educação;7/2020;1786093;11873;31754;-19881
Educação;7/2021;1771752;33175;37551;-4376
Educação;7/2022;1889483;43166;50596;-7430
Educação;8/2020;1777607;20628;29114;-8486
Educação;8/2021;1796943;65446;40255;25191
Educação;8/2022;1918141;80311;51653;28658
Educação;9/2020;1768557;19176;28226;-9050
Educação;9/2021;1812950;51394;35387;16007
Educação;9/2022;1931774;54893;41260;13633
Eletricidade e Gás;1/2020;127679;1161;1444;-283
Eletricidade e Gás;1/2021;129019;1672;1160;512
Eletricidade e Gás;1/2022;131229;1431;1409;22
Eletricidade e Gás;1/2023;131088;1373;1484;-111
Eletricidade e Gás;10/2020;128523;1382;1029;353
Eletricidade e Gás;10/2021;131954;1816;1515;301
Eletricidade e Gás;10/2022;132007;1254;1444;-190
Eletricidade e Gás;11/2020;128837;1539;1225;314
Eletricidade e Gás;11/2021;131783;1672;1843;-171
Eletricidade e Gás;11/2022;132227;1431;1211;220
Eletricidade e Gás;12/2020;128507;1091;1421;-330
Eletricidade e Gás;12/2021;131207;1210;1786;-576
Eletricidade e Gás;12/2022;131199;1049;2077;-1028
Eletricidade e Gás;2/2020;127970;1492;1201;291
Eletricidade e Gás;2/2021;129425;1842;1436;406
Eletricidade e Gás;2/2022;131086;1663;1806;-143
Eletricidade e Gás;2/2023;131281;1742;1549;193
Eletricidade e Gás;3/2020;128139;1264;1095;169
Eletricidade e Gás;3/2021;129118;1626;1933;-307
Eletricidade e Gás;3/2022;131286;1612;1412;200
Eletricidade e Gás;3/2023;131373;1722;1630;92
Eletricidade e Gás;4/2020;128189;667;617;50
Eletricidade e Gás;4/2021;129558;1936;1496;440
Eletricidade e Gás;4/2022;131129;1595;1752;-157
Eletricidade e Gás;4/2023;131444;1958;1887;71
Eletricidade e Gás;5/2020;128200;724;713;11
Eletricidade e Gás;5/2021;129777;1674;1455;219
Eletricidade e Gás;5/2022;131002;1506;1633;-127
Eletricidade e Gás;5/2023;131657;1801;1588;213
Eletricidade e Gás;6/2020;127866;750;1084;-334
Eletricidade e Gás;6/2021;130559;2094;1312;782
Eletricidade e Gás;6/2022;131162;1685;1525;160
Eletricidade e Gás;7/2020;127902;1020;984;36
Eletricidade e Gás;7/2021;130978;1750;1331;419
Eletricidade e Gás;7/2022;131620;1669;1211;458
Eletricidade e Gás;8/2020;128022;1129;1009;120
Eletricidade e Gás;8/2021;131335;1990;1633;357
Eletricidade e Gás;8/2022;131885;1685;1420;265
Eletricidade e Gás;9/2020;128170;1309;1161;148
Eletricidade e Gás;9/2021;131653;2083;1765;318
Eletricidade e Gás;9/2022;132197;1676;1364;312
Indústrias Extrativas;1/2020;218065;3284;3127;157
Indústrias Extrativas;1/2021;223922;4711;3227;1484
Indústrias Extrativas;1/2022;241308;4481;3974;507
Indústrias Extrativas;1/2023;253964;5157;4816;341
Indústrias Extrativas;10/2020;221899;4682;3462;1220
Indústrias Extrativas;10/2021;241467;5326;4175;1151
Indústrias Extrativas;10/2022;253057;5817;5132;685
Indústrias Extrativas;11/2020;222979;4383;3303;1080
Indústrias Extrativas;11/2021;241926;4588;4129;459
Indústrias Extrativas;11/2022;253961;5644;4740;904
Indústrias Extrativas;12/2020;222438;3405;3946;-541
Indústrias Extrativas;12/2021;240801;3628;4753;-1125
Indústrias Extrativas;12/2022;253623;4145;4483;-338
Indústrias Extrativas;2/2020;219404;4463;3124;1339
Indústrias Extrativas;2/2021;226270;5560;3212;2348
Indústrias Extrativas;2/2022;243212;6167;4263;1904
Indústrias Extrativas;2/2023;255289;5802;4477;1325
Indústrias Extrativas;3/2020;219211;3685;3878;-193
Indústrias Extrativas;3/2021;227676;5477;4071;1406
Indústrias Extrativas;3/2022;244103;5492;4601;891
Indústrias Extrativas;3/2023;256855;6720;5154;1566
Indústrias Extrativas;4/2020;217925;2063;3349;-1286
Indústrias Extrativas;4/2021;230044;5715;3347;2368
Indústrias Extrativas;4/2022;245594;5767;4276;1491
Indústrias Extrativas;4/2023;259330;6933;4458;2475
Indústrias Extrativas;5/2020;217381;2598;3142;-544
Indústrias Extrativas;5/2021;232594;6209;3659;2550
Indústrias Extrativas;5/2022;247115;6098;4577;1521
Indústrias Extrativas;5/2023;261974;7583;4939;2644
Indústrias Extrativas;6/2020;218017;3563;2927;636
Indústrias Extrativas;6/2021;234833;5903;3664;2239
Indústrias Extrativas;6/2022;248452;5673;4336;1337
Indústrias Extrativas;7/2020;218908;4062;3171;891
Indústrias Extrativas;7/2021;236967;6080;3946;2134
Indústrias Extrativas;7/2022;250023;5960;4389;1571
Indústrias Extrativas;8/2020;219782;4400;3526;874
Indústrias Extrativas;8/2021;238648;5921;4240;1681
Indústrias Extrativas;8/2022;251253;6202;4972;1230
Indústrias Extrativas;9/2020;220679;4611;3714;897
Indústrias Extrativas;9/2021;240316;5947;4279;1668
Indústrias Extrativas;9/2022;252372;5899;4780;1119
Indústrias de Transformação;1/2020;6860903;229525;174052;55473
Indústrias de Transformação;1/2021;6983487;281902;194924;86978
Indústrias de Transformação;1/2022;7396090;269125;220323;48802
Indústrias de Transformação;1/2023;7605878;280151;246413;33738
Indústrias de Transformação;10/2020;6889325;272580;190568;82012
Indústrias de Transformação;10/2021;7429652;254012;230265;23747
Indústrias de Transformação;10/2022;7711760;246992;233897;13095
Indústrias de Transformação;11/2020;6937413;240342;192254;48088
Indústrias de Transformação;11/2021;7435584;227410;221478;5932
Indústrias de Transformação;11/2022;7685132;213591;240219;-26628
Indústrias de Transformação;12/2020;6896509;164071;204975;-40904
Indústrias de Transformação;12/2021;7347288;152635;240931;-88296
Indústrias de Transformação;12/2022;7572140;142949;255941;-112992
Indústrias de Transformação;2/2020;6894126;236146;202923;33223
Indústrias de Transformação;2/2021;7071033;305903;218357;87546
Indústrias de Transformação;2/2022;7434665;293977;255402;38575
Indústrias de Transformação;2/2023;7643068;287191;250001;37190
Indústrias de Transformação;3/2020;6859943;213587;247770;-34183
Indústrias de Transformação;3/2021;7109213;277754;239574;38180
Indústrias de Transformação;3/2022;7446753;290189;278101;12088
Indústrias de Transformação;3/2023;7660944;314684;296808;17876
Indústrias de Transformação;4/2020;6659183;89813;290573;-200760
Indústrias de Transformação;4/2021;7125681;227656;211188;16468
Indústrias de Transformação;4/2022;7469273;268011;245491;22520
Indústrias de Transformação;4/2023;7675130;271801;257615;14186
Indústrias de Transformação;5/2020;6561279;95469;193373;-97904
Indústrias de Transformação;5/2021;7164458;240874;202097;38777
Indústrias de Transformação;5/2022;7511354;289639;247558;42081
Indústrias de Transformação;5/2023;7680887;286309;280552;5757
Indústrias de Transformação;6/2020;6556837;137323;141765;-4442
Indústrias de Transformação;6/2021;7209431;244921;199948;44973
Indústrias de Transformação;6/2022;7549340;274845;236859;37986
Indústrias de Transformação;7/2020;6608938;197406;145305;52101
Indústrias de Transformação;7/2021;7263824;262016;207623;54393
Indústrias de Transformação;7/2022;7595611;285057;238786;46271
Indústrias de Transformação;8/2020;6699125;244024;153837;90187
Indústrias de Transformação;8/2021;7333128;294060;224756;69304
Indústrias de Transformação;8/2022;7644542;305511;256580;48931
Indústrias de Transformação;9/2020;6807313;282477;174289;108188
Indústrias de Transformação;9/2021;7405905;293711;220934;72777
Indústrias de Transformação;9/2022;7698665;289425;235302;54123
Informação e Comunicação;1/2020;924244;30854;25332;5522
Informação e Comunicação;1/2021;955748;34255;27650;6605
Informação e Comunicação;1/2022;1078832;43182;35830;7352
Informação e Comunicação;1/2023;1143793;37609;36604;1005
Informação e Comunicação;10/2020;945175;38738;24356;14382
Informação e Comunicação;10/2021;1054700;44152;32844;11308
Informação e Comunicação;10/2022;1144217;39427;37397;2030
Informação e Comunicação;11/2020;946324;32131;30982;1149
Informação e Comunicação;11/2021;1066703;43322;31319;12003
Informação e Comunicação;11/2022;1146418;37142;34941;2201
Informação e Comunicação;12/2020;949143;26857;24038;2819
Informação e Comunicação;12/2021;1071480;36326;31549;4777
Informação e Comunicação;12/2022;1142788;27118;30748;-3630
Informação e Comunicação;2/2020;928317;29035;24962;4073
Informação e Comunicação;2/2021;965738;36304;26314;9990
Informação e Comunicação;2/2022;1086740;44480;36572;7908
Informação e Comunicação;2/2023;1142998;33267;34062;-795
Informação e Comunicação;3/2020;928286;29298;29329;-31
Informação e Comunicação;3/2021;977499;41017;29256;11761
Informação e Comunicação;3/2022;1096554;47357;37543;9814
Informação e Comunicação;3/2023;1144166;39619;38451;1168
Informação e Comunicação;4/2020;915099;12245;25432;-13187
Informação e Comunicação;4/2021;987512;37781;27768;10013
Informação e Comunicação;4/2022;1105020;44486;36020;8466
Informação e Comunicação;4/2023;1146706;36199;33659;2540
Informação e Comunicação;5/2020;910162;13871;18808;-4937
Informação e Comunicação;5/2021;998266;39763;29009;10754
Informação e Comunicação;5/2022;1113511;45251;36760;8491
Informação e Comunicação;5/2023;1149699;39479;36486;2993
Informação e Comunicação;6/2020;911406;19171;17927;1244
Informação e Comunicação;6/2021;1010611;42468;30123;12345
Informação e Comunicação;6/2022;1122209;45476;36778;8698
Informação e Comunicação;7/2020;915773;23734;19367;4367
Informação e Comunicação;7/2021;1021964;42749;31396;11353
Informação e Comunicação;7/2022;1127552;41737;36394;5343
Informação e Comunicação;8/2020;921674;27243;21342;5901
Informação e Comunicação;8/2021;1033529;43843;32278;11565
Informação e Comunicação;8/2022;1134125;44441;37868;6573
Informação e Comunicação;9/2020;930793;32220;23101;9119
Informação e Comunicação;9/2021;1043392;43385;33522;9863
Informação e Comunicação;9/2022;1142187;44193;36131;8062
Não identificado***;1/2020;0;0;0;0
Não identificado***;1/2021;0;0;0;0
Não identificado***;1/2022;0;0;2;-2
Não identificado***;1/2023;0;0;0;0
Não identificado***;10/2020;0;0;0;0
Não identificado***;10/2021;0;0;2;-2
Não identificado***;10/2022;0;0;0;0
Não identificado***;11/2020;0;0;0;0
Não identificado***;11/2021;0;0;0;0
Não identificado***;11/2022;0;0;0;0
Não identificado***;12/2020;0;0;0;0
Não identificado***;12/2021;0;0;1;-1
Não identificado***;12/2022;0;0;0;0
Não identificado***;2/2020;0;0;1;-1
Não identificado***;2/2021;0;0;0;0
Não identificado***;2/2022;0;0;1;-1
Não identificado***;2/2023;0;0;0;0
Não identificado***;3/2020;0;0;0;0
Não identificado***;3/2021;0;0;0;0
Não identificado***;3/2022;0;0;0;0
Não identificado***;3/2023;0;0;0;0
Não identificado***;4/2020;0;0;0;0
Não identificado***;4/2021;0;0;0;0
Não identificado***;4/2022;0;0;0;0
Não identificado***;4/2023;0;0;0;0
Não identificado***;5/2020;0;0;1;-1
Não identificado***;5/2021;0;0;1;-1
Não identificado***;5/2022;0;0;0;0
Não identificado***;5/2023;0;0;3;-3
Não identificado***;6/2020;0;0;0;0
Não identificado***;6/2021;0;0;0;0
Não identificado***;6/2022;0;0;0;0
Não identificado***;7/2020;0;0;0;0
Não identificado***;7/2021;0;0;1;-1
Não identificado***;7/2022;0;0;0;0
Não identificado***;8/2020;0;0;0;0
Não identificado***;8/2021;0;0;1;-1
Não identificado***;8/2022;0;0;0;0
Não identificado***;9/2020;0;0;0;0
Não identificado***;9/2021;0;0;0;0
Não identificado***;9/2022;0;0;0;0
Organismos Internacionais e Outras Instituições Extraterritoriais;1/2020;2936;35;30;5
Organismos Internacionais e Outras Instituições Extraterritoriais;1/2021;2933;20;21;-1
Organismos Internacionais e Outras Instituições Extraterritoriais;1/2022;2968;34;37;-3
Organismos Internacionais e Outras Instituições Extraterritoriais;1/2023;3024;40;53;-13
Organismos Internacionais e Outras Instituições Extraterritoriais;10/2020;2934;21;18;3
Organismos Internacionais e Outras Instituições Extraterritoriais;10/2021;2981;29;20;9
Organismos Internacionais e Outras Instituições Extraterritoriais;10/2022;3032;39;49;-10
Organismos Internacionais e Outras Instituições Extraterritoriais;11/2020;2932;13;15;-2
Organismos Internacionais e Outras Instituições Extraterritoriais;11/2021;2982;27;26;1
Organismos Internacionais e Outras Instituições Extraterritoriais;11/2022;3037;46;41;5
Organismos Internacionais e Outras Instituições Extraterritoriais;12/2020;2934;14;12;2
Organismos Internacionais e Outras Instituições Extraterritoriais;12/2021;2971;21;32;-11
Organismos Internacionais e Outras Instituições Extraterritoriais;12/2022;3037;48;48;0
Organismos Internacionais e Outras Instituições Extraterritoriais;2/2020;2944;26;18;8
Organismos Internacionais e Outras Instituições Extraterritoriais;2/2021;2931;18;20;-2
Organismos Internacionais e Outras Instituições Extraterritoriais;2/2022;2978;45;35;10
Organismos Internacionais e Outras Instituições Extraterritoriais;2/2023;3019;29;34;-5
Organismos Internacionais e Outras Instituições Extraterritoriais;3/2020;2951;26;19;7
Organismos Internacionais e Outras Instituições Extraterritoriais;3/2021;2931;18;18;0
Organismos Internacionais e Outras Instituições Extraterritoriais;3/2022;3010;61;29;32
Organismos Internacionais e Outras Instituições Extraterritoriais;3/2023;3010;47;56;-9
Organismos Internacionais e Outras Instituições Extraterritoriais;4/2020;2946;6;11;-5
Organismos Internacionais e Outras Instituições Extraterritoriais;4/2021;2939;29;21;8
Organismos Internacionais e Outras Instituições Extraterritoriais;4/2022;3018;37;29;8
Organismos Internacionais e Outras Instituições Extraterritoriais;4/2023;3016;52;46;6
Organismos Internacionais e Outras Instituições Extraterritoriais;5/2020;2946;12;12;0
Organismos Internacionais e Outras Instituições Extraterritoriais;5/2021;2950;27;16;11
Organismos Internacionais e Outras Instituições Extraterritoriais;5/2022;3029;37;26;11
Organismos Internacionais e Outras Instituições Extraterritoriais;5/2023;3026;62;52;10
Organismos Internacionais e Outras Instituições Extraterritoriais;6/2020;2933;11;24;-13
Organismos Internacionais e Outras Instituições Extraterritoriais;6/2021;2951;24;23;1
Organismos Internacionais e Outras Instituições Extraterritoriais;6/2022;3034;41;36;5
Organismos Internacionais e Outras Instituições Extraterritoriais;7/2020;2938;18;13;5
Organismos Internacionais e Outras Instituições Extraterritoriais;7/2021;2962;24;13;11
Organismos Internacionais e Outras Instituições Extraterritoriais;7/2022;3041;41;34;7
Organismos Internacionais e Outras Instituições Extraterritoriais;8/2020;2942;11;7;4
Organismos Internacionais e Outras Instituições Extraterritoriais;8/2021;2964;26;24;2
Organismos Internacionais e Outras Instituições Extraterritoriais;8/2022;3052;46;35;11
Organismos Internacionais e Outras Instituições Extraterritoriais;9/2020;2931;17;28;-11
Organismos Internacionais e Outras Instituições Extraterritoriais;9/2021;2972;19;11;8
Organismos Internacionais e Outras Instituições Extraterritoriais;9/2022;3042;43;53;-10
Outras Atividades de Serviços;1/2020;929512;28972;26848;2124
Outras Atividades de Serviços;1/2021;904396;26087;23177;2910
Outras Atividades de Serviços;1/2022;969898;35639;32678;2961
Outras Atividades de Serviços;1/2023;1026069;34903;33598;1305
Outras Atividades de Serviços;10/2020;901174;24779;24942;-163
Outras Atividades de Serviços;10/2021;970123;35533;26628;8905
Outras Atividades de Serviços;10/2022;1040999;36000;34201;1799
Outras Atividades de Serviços;11/2020;906598;24645;19221;5424
Outras Atividades de Serviços;11/2021;978284;34567;26406;8161
Outras Atividades de Serviços;11/2022;1041404;32230;31825;405
Outras Atividades de Serviços;12/2020;901486;20629;25741;-5112
Outras Atividades de Serviços;12/2021;966937;26387;37734;-11347
Outras Atividades de Serviços;12/2022;1024764;25176;41816;-16640
Outras Atividades de Serviços;2/2020;935400;36552;30664;5888
Outras Atividades de Serviços;2/2021;914196;33832;24032;9800
Outras Atividades de Serviços;2/2022;988295;51364;32967;18397
Outras Atividades de Serviços;2/2023;1036193;43511;33387;10124
Outras Atividades de Serviços;3/2020;932243;28488;31645;-3157
Outras Atividades de Serviços;3/2021;918811;31024;26409;4615
Outras Atividades de Serviços;3/2022;997914;46960;37341;9619
Outras Atividades de Serviços;3/2023;1042106;44819;38906;5913
Outras Atividades de Serviços;4/2020;913893;9939;28289;-18350
Outras Atividades de Serviços;4/2021;924036;27415;22190;5225
Outras Atividades de Serviços;4/2022;1005923;41848;33839;8009
Outras Atividades de Serviços;4/2023;1048070;37670;31706;5964
Outras Atividades de Serviços;5/2020;904908;12476;21461;-8985
Outras Atividades de Serviços;5/2021;933153;32899;23782;9117
Outras Atividades de Serviços;5/2022;1013464;41891;34350;7541
Outras Atividades de Serviços;5/2023;1052909;39431;34592;4839
Outras Atividades de Serviços;6/2020;901048;14133;17993;-3860
Outras Atividades de Serviços;6/2021;938577;30399;24975;5424
Outras Atividades de Serviços;6/2022;1020977;39461;31948;7513
Outras Atividades de Serviços;7/2020;899541;17135;18642;-1507
Outras Atividades de Serviços;7/2021;944553;31898;25922;5976
Outras Atividades de Serviços;7/2022;1026499;38112;32590;5522
Outras Atividades de Serviços;8/2020;899431;19729;19839;-110
Outras Atividades de Serviços;8/2021;953385;37013;28181;8832
Outras Atividades de Serviços;8/2022;1033868;43597;36228;7369
Outras Atividades de Serviços;9/2020;901337;22451;20545;1906
Outras Atividades de Serviços;9/2021;961218;35970;28137;7833
Outras Atividades de Serviços;9/2022;1039200;39903;34571;5332
Saúde Humana e Serviços Sociais;1/2020;2381637;55532;50013;5519
Saúde Humana e Serviços Sociais;1/2021;2501154;75972;54507;21465
Saúde Humana e Serviços Sociais;1/2022;2676572;89473;72315;17158
Saúde Humana e Serviços Sociais;1/2023;2765359;80697;74945;5752
Saúde Humana e Serviços Sociais;10/2020;2457406;63690;58088;5602
Saúde Humana e Serviços Sociais;10/2021;2656039;74366;70176;4190
Saúde Humana e Serviços Sociais;10/2022;2764583;74835;70773;4062
Saúde Humana e Serviços Sociais;11/2020;2472285;63732;48853;14879
Saúde Humana e Serviços Sociais;11/2021;2663470;72284;64853;7431
Saúde Humana e Serviços Sociais;11/2022;2770454;71621;65750;5871
Saúde Humana e Serviços Sociais;12/2020;2479689;66479;59075;7404
Saúde Humana e Serviços Sociais;12/2021;2659414;66496;70552;-4056
Saúde Humana e Serviços Sociais;12/2022;2759607;61913;72760;-10847
Saúde Humana e Serviços Sociais;2/2020;2391350;60283;50570;9713
Saúde Humana e Serviços Sociais;2/2021;2527054;81793;55893;25900
Saúde Humana e Serviços Sociais;2/2022;2699963;99093;75702;23391
Saúde Humana e Serviços Sociais;2/2023;2777452;87067;74974;12093
Saúde Humana e Serviços Sociais;3/2020;2400817;64766;55299;9467
Saúde Humana e Serviços Sociais;3/2021;2566653;107555;67956;39599
Saúde Humana e Serviços Sociais;3/2022;2703975;89788;85776;4012
Saúde Humana e Serviços Sociais;3/2023;2791666;101124;86910;14214
Saúde Humana e Serviços Sociais;4/2020;2403695;58732;55854;2878
Saúde Humana e Serviços Sociais;4/2021;2596893;91794;61554;30240
Saúde Humana e Serviços Sociais;4/2022;2714276;88967;78666;10301
Saúde Humana e Serviços Sociais;4/2023;2810000;92162;73828;18334
Saúde Humana e Serviços Sociais;5/2020;2411039;55020;47676;7344
Saúde Humana e Serviços Sociais;5/2021;2613317;77806;61382;16424
Saúde Humana e Serviços Sociais;5/2022;2725092;89861;79045;10816
Saúde Humana e Serviços Sociais;5/2023;2823876;93189;79313;13876
Saúde Humana e Serviços Sociais;6/2020;2424598;58809;45250;13559
Saúde Humana e Serviços Sociais;6/2021;2630848;81907;64376;17531
Saúde Humana e Serviços Sociais;6/2022;2737321;87662;75433;12229
Saúde Humana e Serviços Sociais;7/2020;2438118;63240;49720;13520
Saúde Humana e Serviços Sociais;7/2021;2640981;79526;69393;10133
Saúde Humana e Serviços Sociais;7/2022;2750957;91424;77788;13636
Saúde Humana e Serviços Sociais;8/2020;2446094;63675;55699;7976
Saúde Humana e Serviços Sociais;8/2021;2649528;80666;72119;8547
Saúde Humana e Serviços Sociais;8/2022;2755758;90456;85655;4801
Saúde Humana e Serviços Sociais;9/2020;2451804;60645;54935;5710
Saúde Humana e Serviços Sociais;9/2021;2651849;75114;72793;2321
Saúde Humana e Serviços Sociais;9/2022;2760521;81050;76287;4763
Serviços domésticos;1/2020;650;68;67;1
Serviços domésticos;1/2021;737;78;72;6
Serviços domésticos;1/2022;1112;135;91;44
Serviços domésticos;1/2023;1212;67;88;-21
Serviços domésticos;10/2020;674;88;69;19
Serviços domésticos;10/2021;1049;120;174;-54
Serviços domésticos;10/2022;1218;140;114;26
Serviços domésticos;11/2020;703;65;36;29
Serviços domésticos;11/2021;1065;119;103;16
Serviços domésticos;11/2022;1250;140;108;32
Serviços domésticos;12/2020;731;65;37;28
Serviços domésticos;12/2021;1068;112;109;3
Serviços domésticos;12/2022;1233;80;97;-17
Serviços domésticos;2/2020;654;69;65;4
Serviços domésticos;2/2021;786;95;46;49
Serviços domésticos;2/2022;1112;109;109;0
Serviços domésticos;2/2023;1239;101;74;27
Serviços domésticos;3/2020;663;54;45;9
Serviços domésticos;3/2021;811;109;84;25
Serviços domésticos;3/2022;1086;111;137;-26
Serviços domésticos;3/2023;1226;73;86;-13
Serviços domésticos;4/2020;626;17;54;-37
Serviços domésticos;4/2021;908;173;76;97
Serviços domésticos;4/2022;1104;123;105;18
Serviços domésticos;4/2023;1226;56;56;0
Serviços domésticos;5/2020;613;29;42;-13
Serviços domésticos;5/2021;933;99;74;25
Serviços domésticos;5/2022;1127;134;111;23
Serviços domésticos;5/2023;1252;86;60;26
Serviços domésticos;6/2020;616;44;41;3
Serviços domésticos;6/2021;964;98;67;31
Serviços domésticos;6/2022;1144;136;119;17
Serviços domésticos;7/2020;630;55;41;14
Serviços domésticos;7/2021;1010;119;73;46
Serviços domésticos;7/2022;1154;128;118;10
Serviços domésticos;8/2020;637;44;37;7
Serviços domésticos;8/2021;1071;136;75;61
Serviços domésticos;8/2022;1175;130;109;21
Serviços domésticos;9/2020;655;55;37;18
Serviços domésticos;9/2021;1103;115;83;32
Serviços domésticos;9/2022;1192;119;102;17
Transporte, armazenagem e correio;1/2020;2318213;65619;67714;-2095
Transporte, armazenagem e correio;1/2021;2270492;70636;70054;582
Transporte, armazenagem e correio;1/2022;2395690;89047;83217;5830
Transporte, armazenagem e correio;1/2023;2522340;92909;90221;2688
Transporte, armazenagem e correio;10/2020;2254974;84679;67718;16961
Transporte, armazenagem e correio;10/2021;2383791;94768;81000;13768
Transporte, armazenagem e correio;10/2022;2527616;94465;84036;10429
Transporte, armazenagem e correio;11/2020;2272876;84360;66458;17902
Transporte, armazenagem e correio;11/2021;2401821;97221;79191;18030
Transporte, armazenagem e correio;11/2022;2538637;94681;83660;11021
Transporte, armazenagem e correio;12/2020;2269910;67425;70391;-2966
Transporte, armazenagem e correio;12/2021;2389860;77707;89668;-11961
Transporte, armazenagem e correio;12/2022;2519652;74863;93848;-18985
Transporte, armazenagem e correio;2/2020;2326462;75198;66949;8249
Transporte, armazenagem e correio;2/2021;2281453;85014;74053;10961
Transporte, armazenagem e correio;2/2022;2409750;105318;91258;14060
Transporte, armazenagem e correio;2/2023;2539041;105009;88308;16701
Transporte, armazenagem e correio;3/2020;2321012;73853;79303;-5450
Transporte, armazenagem e correio;3/2021;2294740;87952;74665;13287
Transporte, armazenagem e correio;3/2022;2425993;106403;90160;16243
Transporte, armazenagem e correio;3/2023;2562463;119912;96490;23422
Transporte, armazenagem e correio;4/2020;2268258;36059;88813;-52754
Transporte, armazenagem e correio;4/2021;2299143;77887;73484;4403
Transporte, armazenagem e correio;4/2022;2442277;103783;87499;16284
Transporte, armazenagem e correio;4/2023;2578568;103011;86906;16105
Transporte, armazenagem e correio;5/2020;2240445;36190;64003;-27813
Transporte, armazenagem e correio;5/2021;2306398;79296;72041;7255
Transporte, armazenagem e correio;5/2022;2457056;105734;90955;14779
Transporte, armazenagem e correio;5/2023;2586081;106583;99070;7513
Transporte, armazenagem e correio;6/2020;2231595;47990;56840;-8850
Transporte, armazenagem e correio;6/2021;2319114;82724;70008;12716
Transporte, armazenagem e correio;6/2022;2473807;102200;85449;16751
Transporte, armazenagem e correio;7/2020;2228136;60111;63570;-3459
Transporte, armazenagem e correio;7/2021;2333411;88687;74390;14297
Transporte, armazenagem e correio;7/2022;2487200;98793;85400;13393
Transporte, armazenagem e correio;8/2020;2227705;65228;65659;-431
Transporte, armazenagem e correio;8/2021;2352090;94101;75422;18679
Transporte, armazenagem e correio;8/2022;2501318;106405;92287;14118
Transporte, armazenagem e correio;9/2020;2238013;74279;63971;10308
Transporte, armazenagem e correio;9/2021;2370023;96158;78225;17933
Transporte, armazenagem e correio;9/2022;2517187;99479;83610;15869
Água, Esgoto, Atividades de Gestão de Resíduos e Descontaminação;1/2020;343574;6796;6310;486
Água, Esgoto, Atividades de Gestão de Resíduos e Descontaminação;1/2021;344818;7755;6493;1262
Água, Esgoto, Atividades de Gestão de Resíduos e Descontaminação;1/2022;360968;9636;7548;2088
Água, Esgoto, Atividades de Gestão de Resíduos e Descontaminação;1/2023;380928;9893;9838;55
Água, Esgoto, Atividades de Gestão de Resíduos e Descontaminação;10/2020;343652;8355;6157;2198
Água, Esgoto, Atividades de Gestão de Resíduos e Descontaminação;10/2021;358973;9450;7952;1498
Água, Esgoto, Atividades de Gestão de Resíduos e Descontaminação;10/2022;380964;9255;7954;1301
Água, Esgoto, Atividades de Gestão de Resíduos e Descontaminação;11/2020;344683;7144;6113;1031
Água, Esgoto, Atividades de Gestão de Resíduos e Descontaminação;11/2021;360930;9521;7564;1957
Água, Esgoto, Atividades de Gestão de Resíduos e Descontaminação;11/2022;380761;8764;8967;-203
Água, Esgoto, Atividades de Gestão de Resíduos e Descontaminação;12/2020;343556;5884;7011;-1127
Água, Esgoto, Atividades de Gestão de Resíduos e Descontaminação;12/2021;358880;8610;10660;-2050
Água, Esgoto, Atividades de Gestão de Resíduos e Descontaminação;12/2022;380873;8076;7964;112
Água, Esgoto, Atividades de Gestão de Resíduos e Descontaminação;2/2020;344953;8376;6997;1379
Água, Esgoto, Atividades de Gestão de Resíduos e Descontaminação;2/2021;347517;8984;6285;2699
Água, Esgoto, Atividades de Gestão de Resíduos e Descontaminação;2/2022;363632;11026;8362;2664
Água, Esgoto, Atividades de Gestão de Resíduos e Descontaminação;2/2023;382600;11079;9407;1672
Água, Esgoto, Atividades de Gestão de Resíduos e Descontaminação;3/2020;345419;7437;6971;466
Água, Esgoto, Atividades de Gestão de Resíduos e Descontaminação;3/2021;349030;9197;7684;1513
Água, Esgoto, Atividades de Gestão de Resíduos e Descontaminação;3/2022;365713;11719;9638;2081
Água, Esgoto, Atividades de Gestão de Resíduos e Descontaminação;3/2023;384050;11844;10394;1450
Água, Esgoto, Atividades de Gestão de Resíduos e Descontaminação;4/2020;342337;3715;6797;-3082
Água, Esgoto, Atividades de Gestão de Resíduos e Descontaminação;4/2021;348394;7701;8337;-636
Água, Esgoto, Atividades de Gestão de Resíduos e Descontaminação;4/2022;368237;10512;7988;2524
Água, Esgoto, Atividades de Gestão de Resíduos e Descontaminação;4/2023;386031;10581;8600;1981
Água, Esgoto, Atividades de Gestão de Resíduos e Descontaminação;5/2020;340109;4166;6394;-2228
Água, Esgoto, Atividades de Gestão de Resíduos e Descontaminação;5/2021;350611;9397;7180;2217
Água, Esgoto, Atividades de Gestão de Resíduos e Descontaminação;5/2022;371737;11696;8196;3500
Água, Esgoto, Atividades de Gestão de Resíduos e Descontaminação;5/2023;385846;10262;10447;-185
Água, Esgoto, Atividades de Gestão de Resíduos e Descontaminação;6/2020;338732;4338;5715;-1377
Água, Esgoto, Atividades de Gestão de Resíduos e Descontaminação;6/2021;352739;9162;7034;2128
Água, Esgoto, Atividades de Gestão de Resíduos e Descontaminação;6/2022;373771;11127;9093;2034
Água, Esgoto, Atividades de Gestão de Resíduos e Descontaminação;7/2020;338335;5310;5707;-397
Água, Esgoto, Atividades de Gestão de Resíduos e Descontaminação;7/2021;354623;8585;6701;1884
Água, Esgoto, Atividades de Gestão de Resíduos e Descontaminação;7/2022;375974;10637;8434;2203
Água, Esgoto, Atividades de Gestão de Resíduos e Descontaminação;8/2020;339987;6833;5181;1652
Água, Esgoto, Atividades de Gestão de Resíduos e Descontaminação;8/2021;356043;8843;7423;1420
Água, Esgoto, Atividades de Gestão de Resíduos e Descontaminação;8/2022;378308;11040;8706;2334
Água, Esgoto, Atividades de Gestão de Resíduos e Descontaminação;9/2020;341454;7179;5712;1467
Água, Esgoto, Atividades de Gestão de Resíduos e Descontaminação;9/2021;357475;8737;7305;1432
Água, Esgoto, Atividades de Gestão de Resíduos e Descontaminação;9/2022;379663;9362;8007;1355
